{
"title": "Bluth City",
"ids": [{ "currentID": 1, "leftMap": 2, "rightMap": 3, "upMap": 4, "downMap": 5}],
"items": [
        { "id": 3, "x": 11, "y": 9},
        { "id": 1, "x": 14, "y": 3},
        { "id": 2, "x": 8, "y": 4}
],
"monsters": [
        { "id": 17, "x": 13, "y": 6},
        { "id": 11, "x": 7, "y": 2},
        { "id": 5, "x": 5, "y": 6},
        { "id": "10", "x": 2, "y": 7}
],
"entrances": [
        { "x": 9, "y": 5, "tile_after": 9, "item_req": 7}
],
"signs": [
        { "x": 0, "y": 15, "text": "Hello world."}
],
"teleports": [
        { "fromX": 14, "fromY": 9, "fromMap": 1, "toX": 1, "toY": 2, "toMap": 3, "item_req": 4}
],
"map": [ 
[ 1, 1, 1, 1, 1, 1, 1, 190, 115, 1, 1, 1, 1, 1, 1, 2],
[ 190, 190, 190, 190, 190, 190, 190, 190, 13, 148, 148, 148, 148, 148, 121, 2],
[ 1, 520, 127, 127, 127, 127, 127, 13, 13, 148, 167, 167, 167, 148, 343, 1],
[ 1, 520, 127, 166, 166, 166, 127, 13, 13, 148, 167, 167, 167, 148, 343, 1],
[ 1, 520, 127, 166, 166, 166, 127, 13, 13, 148, 148, 148, 183, 148, 343, 1],
[ 1, 520, 364, 174, 127, 361, 127, 13, 13, 13, 13, 13, 13, 13, 13, 1],
[ 115, 13, 13, 13, 13, 13, 13, 13, 13, 13, 13, 13, 13, 13, 13, 115],
[ 1, 514, 13, 13, 394, 343, 145, 220, 145, 145, 145, 13, 13, 13, 13, 1],
[ 1, 514, 13, 13, 343, 118, 145, 166, 166, 166, 145, 13, 13, 13, 13, 1],
[ 1, 514, 514, 13, 118, 118, 145, 166, 166, 522, 145, 13, 13, 13, 13, 1],
[ 1, 1, 1, 115, 1, 1, 145, 145, 145, 145, 145, 1, 1, 1, 1, 1]
]
}